61
71
#############################################################
#.....#.#.#.#.....#.#.#.#.#...................#...#.....#.#.#
#####.#.#.#.#.#.#.#.#.#.#.###.###################.#.#.#.#.#.#
#...#.#...#.#.#.#.#.....#.#...#.....#...#.#.#.#.#.#.#.#...#.#
#.#.#.#.#.#.#.#######.###.###.#.#####.#.#.#.#.#.#.#.###.###.#
#.#.#...#.#.#.#...#.#...#.#.#.#.....#.#.#.#.#...#.#...#.#.#.#
#.#.#.#.#.#.#.###.#.#.###.#.#.#.###.#.#.#.#.#.#.#.#.#.#.#.#.#
#.#...#.#.#.#...........#.#.#...#.#.#.#.....#.#.#.#.#.#.....#
#.#.#.#.#.#.###########.#.#.#.#.#.#.#.#####.#.#.#.#.#####.#.#
#.#.#.#.#.#.............#.#.#.#.#...#.#...#.#.#...#.#.#...#.#
#.#.#.#.#.#.#########.###.#.#.#.#.#.#.###.#.#.#.###.#.#.#.#.#
#.#.#.#.#.#.#...........#.#.#.#.#.#.#.....#.#.#.#.#...#.#.#.#
#.#.#.#.#.#.#########.#.#.#.#.#.#.#.#######.#.#.#.###.#.#.#.#
#.#.#.#.#.#.#.........#.#.#.#.#.#.#.#.#.#.#.#.#.#.#...#.#.#.#
###.#####.#.#######.#.#.#.#.#.#.#.#.#.#.#.#.#.#.#.#########.#
#.....#.#.#.#.......#.#...#.#.#.#.#.......#.#.#.#.#...#.#.#.#
#.#####.#.#######.#######.#.#.#.#.#.###.#.#.#.#.#.#.###.#.#.#
#.#.#.#.#...............#.#.#.#.#.#.#...#.#.#.#...#.#.#.#.#.#
#.#.#.#.#############.#####.#.#.#.#.###.#.#.#.#.#.#.#.#.#.#.#
#.#.#...#.#...#...#.......#.#.#.#.#.#...#...#.#.#.#.#.#...#.#
#.#.#.#.#.###.###.#.#######.#.#.###.#####.###.#.#.#.#.#.#.#.#
#.....#.#.#.................#.#.#.#.#.......#.#.#.#.#.#.#.#.#
#.#.#.#.#.###########.#####.#.#.#.#.#####.###.#.#.#.#.#.#.#.#
#.#.#.#.#.#.............#.#.#.#.#.#.#...#.#...#.#.#...#.#.#.#
#.#.#.#.#.#.###.#######.#.#.#.#.#.#.###.#.#.#.#.#.###.#.#.#.#
#.#.#.#.#...#.....#.......#...#.#...#.......#.#.#.#.....#.#.#
###.###########.#############################.#.#.#.#######.#
#.#.#.#.#.#.#.#...........#.#.....#.#.#.....#.#.#.#.....#...#
#.#.#.#.#.#.#.#.#########.#.#####.#.#.#.#.#.#.#.#.#.#####.#.#
#.#...#.#.#.#.#.#...#.#...#.#.......#...#.#.#.#.#.#.#...#.#.#
#.#.#.#.#.#.#.#.#.#.#.#.###.#.#.#.#.#.#####.#.#.#.#.#.#.#.#.#
#.#.#.#.#.#.#.#.#.#...#.#.#.#.#.#.#.#.....#.#.#.#.#.#.#.#.#.#
#.#.#.#.#.#.#.#.#####.#.#.#.#.#.#.#.###.###.#.#.#.#.#.#.#.#.#
#...#...#...#.#.#...#.#.#.#.#.#.#.#.......#.#.#.#.#...#...#.#
#####.###.###.#.#.#.#.#.#.#.#.#####.#.#####.#.#.#.#.#.#.#.#.#
#.#.#...#.....#.#.#.......#.#.....#.#.....#...#.#...#.#.#.#.#
#.#.#.#.#.#.#.#.#.#######.#.#######.###.#####.#.#.#.###.#.#.#
#.#.#.#.#.#.#.#.#.....#...#.#...#...#.......#.#.#.#...#.#.#.#
#.#.#.#.###.#######.#######.###.###.###.#.###.#.#.#.#.#.#.#.#
#.....#.#.#.#.#...........#.........#...#...#.#.#.#.#.#.#.#.#
#.#.#.#.#.#.#.###########.###########.#######################
#.#.#.#.#.#.#.#.#.........#...........#.....................#
#.#.#.#.#.#.#.#.#.#####.#.#.#.#####.#############.#.#.###.###
#.#.#.#.#.#...........#.#.#.#.....#...............#.#...#...#
#.###.#.#.#.###.###.#######.#####################.#######.###
#...#.#.#.....#.#.........#.......#...............#.........#
#####################.#####.#################################
#.................#.#.#.#.#.#.#.#.#...#...........#.........#
###.#############.#.#.#.#.#.#.#.#.###.###.#####.#######.###.#
#.#.#...#.......#.#.#...#.#.#.....#...#.......#...#.....#.#.#
#.#.#.###.#####.#.#.#.###.#.#.#.#####.###########.#.#.#.#.#.#
#.#.#.........#.#...#...#.#.#.#...#...............#.#.#...#.#
#.#.#####.#########.#.###.#.###.#######.###########.#####.#.#
#.........#...#.#.......#.#.#.#...#.#...........#.#.....#.#.#
#.#.#####.#.###.#.###.###.#.#.###.#.#.###########.###.#####.#
#.#.#...........#...#.....#...#...#.............#.#.#.#.#.#.#
#######################.#.#.#.###.#.#############.#.#.#.#.#.#
#.......................#.#.#.#...#...............#...#...#.#
#########.###############.#.#.###.###############.###.#.#.#.#
#.#...#.......#...#.#.#.#.#.#.....................#...#.#.#.#
#.###.###.#####.###.#.#.#.#.#########################.#.#.#.#
#.....#.......#...#...#.#.#.......................#.....#.#.#
###.###.###.###.#.#.#.#.#.#.#########################.#######
#.....#.#.......#.#.#.#.#.#...............#.......#.......#.#
#.#############.#####.#.#.#######.#########.#############.#.#
#.......................#.#...................#.............#
###.#################.###.#####.#######.#.#.#.###.###.#####.#
#.................#.....#.#.......#.....#.#.#.....#.......#.#
#####.#############.#####.#.###############.#########.#####.#
#.................#.....#.#...............#.......#.......#.#
#############################################################
