61
71
#############################################################
#...............#.....#.......#...#...#.................#...#
#.#######.#####.#.###.#####.#.#.#.###.#.#.#############.#.###
#.#.....#.#...#...#.#.......#...#...#...#.#.#.....#.....#...#
###.###.#.#.#.#####.###############.#####.#.#.#.###.#######.#
#...#...#...#.#.................#...#...#.#.#.#...#...#.....#
#.###.#######.#.###.#.###########.###.#.#.#.#.###.###.#.#.###
#.#...........#...#.#.#...........#...#...#.#.#.#.....#.#...#
#.#####.###########.#.#.###########.#######.#.#.###########.#
#...#.#.#.......#...#.#.#.#.......#.....#.....#...........#.#
###.#.#.#.#####.#.#####.#.#.###.#.#####.#.#####.#.#######.#.#
#...#...#.#...#.#.......#...#...#.#.....#.#.#...#.....#...#.#
#.#######.###.#.#.#######.###.###.#.#####.#.#.#######.###.#.#
#.............#.#...#...#.#.#...#...#.....#.#...#...#...#...#
#.#########.###.###.#.#.#.#.###.#####.#####.###.#.#.###.###.#
#.....#...#.#...#...#.#...#.#...#...#.#...#.#...#.#.....#...#
#####.#.#.###.###.###.#####.#.###.#.#.#.#.#.#.###.#######.###
#.....#.#.#...#.#.#.#.......#...#.#.#.#.#.#...#.#.#.....#.#.#
#.#####.#.#.###.#.#.#######.###.#.###.#.#.#.###.#.#.###.#.#.#
#...#...#.#.#...#.#.....#...#.#.#...#...#.#...#.#.#.#.#...#.#
###.#.###.#.#.###.#.###.#.###.#.#.#.#####.###.#.#.#.#.#####.#
#...#.#.#.#.#...#.#...#.......#.#.#.....#...#...#.#.#.......#
#.###.#.#.#.#.#.#.#############.#.#####.###.#####.#.###.###.#
#.#...#.#.#.#.#...#...#.......#.#.#.....#.#.#.....#.....#...#
#.#.###.#.#.#.#####.#.#.#####.#.#.#.###.#.#.#.###########.###
#.#.#.......#...#...#.#...#...#.#.#.#.....#.#.......#...#...#
#.#.###########.#.###.###.#.###.#.#.#.#####.#.#####.#.#.###.#
#.#...#...#...#...#.#.#...#.#...#.#.#.#.....#...#...#.#.....#
#.###.#.#.#.#.#####.#.#.###.#.###.#.###.#######.#.###.#######
#.#...#.#.#.#.....#.....#.#...#...#...#...#.....#.#.........#
#.#.###.#.#####.###.#####.###########.###.#####.#.#########.#
#.#...#.#.....#.....#...#.#...........#...#...#.#...#.......#
#.###.#.#####.#.#####.#.#.#.###.#####.#.###.#.###.#.###.#####
#.#...#...#...#.#.....#.#...#.#.....#.#.....#...#.#...#.#...#
#.#.#####.#.#####.#####.#.###.#####.###########.#.###.#.###.#
#.#.......#...#...#.#...#.#...#.....#.........#.#...#.#.#...#
#.###########.#.###.#.###.#.#.#.###.#.#####.###.###.#.#.#.#.#
#...#.......#...#...#.#.#.#.#.#...#.#.#...#.#...#.#.#.#...#.#
###.###.###.#####.#.#.#.#.###.###.###.###.#.#.###.#.#.#####.#
#...#...#.#...#...#.#.#.#...#...#...#.....#.#...#...#.....#.#
#.###.###.###.#.#####.#.###.#.#.###.#####.#.###.#########.#.#
#.....#.#.....#...#...#...#...#.#.....#...#...............#.#
#######.#.#######.#.###.#.#####.#.#.###.###################.#
#.#.....#.#.......#.#...#.#.....#.#.#.........#.......#.#...#
#.#.#.###.#.#####.#.###.#.#.#####.###.#########.#####.#.#.###
#.#.#...#.#...#...#...#.#.......#.....#.........#.....#...#.#
#.#.###.#.#.#.#######.#.###############.#########.#####.###.#
#.#...#.#.#.#.#.......#.#...#.....#.....#...#.....#...#...#.#
#.#.###.#.###.#.#######.#.#.#.###.#.#####.###.###.#.#.###.#.#
#.#.#...#...#.#.#.#.....#.#...#.#...#.....#...#...#.#.#.#...#
#.#.#.#####.#.#.#.#.#####.#####.#####.###.#.###.###.#.#.###.#
#...#.........#.#.......#.#.....#.....#.#.#...#...#.#.#.....#
#.#############.#.#######.#.###.#####.#.#.###.#####.#.#######
#...#.......#...#...#...#...#.........#.....#.....#.#.#.....#
###.#######.#.#####.#.#.#####.#############.#####.#.#.#.###.#
#...#.....#.#.#.....#.#.....#...#.........#...#.#...#.#...#.#
#.###.###.#.#.#######.###.#####.#.#######.###.#.#####.###.#.#
#...#.#.#.#.#.#.......#.#.....#.#.#.......#.#.......#.....#.#
###.#.#.#.#.#.#.#######.#####.#.#.###.#####.#######.#######.#
#.....#.....#...............#...#...#.....#.......#.....#.#.#
#.###########.#####################.#####.#####.#######.#.#.#
#.#...#.....#.#.................#...#...#.....#.......#...#.#
#.#.#.#.###.###.###############.#.###.#.#####.#####.#.###.#.#
#.#.#...#.#.#...#...........#.#...#...#...#.#.#...#.#...#.#.#
###.#####.#.#.###.#######.#.#.#####.###.#.#.#.#.#.###.###.#.#
#...#.....#.#.#.#.#.#.....#...#...#...#.#...#...#...#.....#.#
#.###.###.#.#.#.#.#.#.#######.#.#.###.#.###########.#.#####.#
#.#.#...#.#...#.#.#.#.#...#...#.#...#.#...#.......#.#.....#.#
#.#.#.#.#######.#.#.#.#.#.#####.###.#.###.#.###.###.#######.#
#.#...#.............#...#.........#.....#.....#.............#
#############################################################
