21
31
#####################
#...........#...#...#
#.#####.###.#.#.###.#
#...#...#.#.#.#.....#
#.###.###.#.#.#####.#
#.#...#...#.#.#...#.#
#.#.###.###.#.#.#.###
#.#.#...#...#...#...#
#.#.#.#.#.#########.#
#.#.#.#...........#.#
###.#############.#.#
#...#...#...#.....#.#
#.###.#.###.#.#####.#
#.....#...#.........#
#.#######.#.#######.#
#.......#.#.#...#.#.#
#######.#.###.#.#.#.#
#...#...#.....#.#.#.#
#.#.#.#########.#.#.#
#.#.....#...#...#...#
#.#######.#.#.###.###
#...#.....#...#.#...#
#####.#########.###.#
#...#.......#.......#
#.#.#.#####.#.#######
#.#.#...#...#...#...#
#.#.#####.#####.###.#
#.#.......#...#...#.#
#.#########.#.###.#.#
#.#.........#.......#
#####################
