31
31
###############################
#.#...#...#...........#.......#
#.#.#.#.#.#.#.#.###.#.###.###.#
#.......#.........#.....#.....#
#.#.#.#.####.##.#.#.#.#.###.#.#
#.#...#.#.....#...#.#.#.....#.#
#.#.#.#.#.###.#.#.#...#.#.###.#
#...#...#...#.#...#.#.........#
#.###.#.###.#.#.#...#.#####.###
#.........#.#.....#.......#...#
###.#.#.#...##.##...#.#.#.#.#.#
#.#.#...#.#.....#.#.#.......#.#
#.#...###.#.###...###.#.#.#...#
#...#.....#...#.#.....#.#...#.#
#.#.####.##.#.#.##.##.#.#####.#
#.#.........#.........#...#...#
#.#.##.##.#.#.#.#.#.#.#.#.#.#.#
#.......#.....#...#.....#...#.#
#######...#.###.#####.#.#.###.#
#.......#...#...#...#.#.......#
#.#.###.###.###...#.#.#.#.#.#.#
#.#...#...#.....#.#...#.#.#...#
#.###.#.#.#.#.###.###.#.#...#.#
#.#.......#...#.........#.#.#.#
###.###.###.#.###.#.#.#.#.#...#
#.......#...............#...#.#
#.###.#...#######.#######.#.#.#
#.#.....#.#.....#.......#...#.#
#.#.##.##.###.#.#####.#.#.#.#.#
#.....................#...#...#
###############################
