31
31
###############################
#...#.......................#.#
#.#...###.#.#.#.####.#.####.#.#
#.#.#.....#.......#.....#.....#
#.#.#.#.#.#.#.###.#.#.#.##.##.#
#.......#...#...#...#.#.......#
#.###.#.#.###.#...#.#.#######.#
#...........#...#.............#
#.#.#.#.###...#.#.#.#######.#.#
#.#.....#.#.#.....#.........#.#
#.#.###.#...#.#.#.#.#.#.###...#
#.#.......#.....#.#.........#.#
#.#.#.###...#.#.#.#.#.#.###.#.#
#.#...#...#.#...#.#.#.#...#...#
#.###.###...#.#...#.#...#.#.#.#
#...#.....#.#...#.#...#.......#
###.####.##.###...#.#.#.#.###.#
#...............#.#...........#
#.#.##.####.#.#...###.#.###.#.#
#.........#.....#...#.....#...#
#.#.#.###.#.#.#.###.###.#...#.#
#.#.#.........#...........#...#
#.#.#.#.#.#.#.#.#.#.#.#.#...#.#
#.#...#...#.......#...#...#...#
#.###...#.#.#.#.#.#####.###.#.#
#.#...#.............#...#...#.#
#.#.#.#.#####.#.###...#.#.#.#.#
#.......#...........#.#.......#
#.#.#.###.#.#.#.##.##.#.#.###.#
#...........#.............#...#
###############################
