31
31
###############################
#.....#...............#...#...#
#####.###.###.#.#####.#.#.#.#.#
#.......#.....#.#.......#...#.#
#.#.###.###.#.#.###.###.###.#.#
#.#.....#...#...#...........#.#
#.#.#.#.###.#.###.#.#.#####.#.#
#...#.#.....#.......#.........#
#.#.#####.#.#.###.#######.#####
#.#.......#.#...#.....#.#.....#
#.######.##.###.###.#.#.#####.#
#.........#...#.....#.....#...#
###.#####.#.###.#.#####.#.#.###
#.....#...#.#.....#.....#.#.#.#
#.#####.#.#.#.#.#.###.###.#.#.#
#...#...#.....#.......#...#...#
#.#.#.#.#.#.###.###.###.#####.#
#.#.........#.............#...#
#.#######.#...#.#.#.#.#.#...###
#.......#...#.............#...#
#.#.###.###.#.#.#.###.#.#.#.#.#
#.#.....#...#.......#.........#
#.#.#####.###.#####.#.####.##.#
#.....#...#.........#.........#
#.###.#.#.#.#.###.####.##.###.#
#.......#.......#.#...........#
#.#####.#######.#.#.#######.#.#
#.#...#.........#...#.........#
#.#.#.#.###.#.#.#.#.###.#.###.#
#.......#.....................#
###############################
