21
21
#####################
#...#.#.....#.......#
#####.#.#.###.###.#.#
#.#.#.#.#.....#.#.#.#
#.#.#.#.#######.#.#.#
#...#...........#.#.#
#.###############.#.#
#.#...........#...#.#
#.#.#########.#.###.#
#...#.....#.#...#...#
#######.#.#.#####.###
#.......#.......#...#
###.#.#############.#
#...#.#...#.........#
#.###.#.#.#.#########
#.#...#.#.#.......#.#
#.#####.#.#######.#.#
#.....#.#.#.....#.#.#
#.###.#.#.#.###.#.#.#
#...#...#.....#.....#
#####################
