31
31
###############################
#.#.........#...#.............#
#.###.###.#.#.#.#.######.##.#.#
#...#...#.#...#.#.#...#...#...#
###.##.##.#.###.#.#.#.#.#.###.#
#...#.....#.#...#...#.........#
#.#.#.#####.#.#.#.#.###.#####.#
#.#...#.....#...#.#...#.....#.#
#.#.#######.###...#.#.#.###.###
#.#.#.......#...#.....#...#...#
#.....#.##.##.#####.###.#.#.#.#
#.#.#.#.....#...........#...#.#
#.#.#######.#.#.######.##.###.#
#.....#...#...#.#.#.....#.....#
#.#.#.#.#.#.#.#.#.#.#.#.##.##.#
#.#.#...#.#.....#.#...#.#.....#
#...#####.#.#####.###.#.#.###.#
#.#...#.....#...#...#.........#
#.###.#.#.###.#.#.###.#.#.#.###
#.#.#.#.#.......#.#.......#...#
#.#.#...#######.#.#.##.######.#
#.#...#...#.#...#.............#
#.#.###.#.#.#.###.####.##.###.#
#.#.#...#.....#...#.........#.#
#.#.###.###.#.#####.#.#.###.#.#
#.#.....#...#.#.........#.....#
#.###########.#.#.#.#####.###.#
#.....#.....#...#...#.....#.#.#
#.#.#.#.###.##.##.#.#.###.#.#.#
#.......#.........#...#.......#
###############################
