21
21
#####################
#...#.......#.......#
###.#.#.#.###.###.#.#
#...#.#.#.....#.#.#.#
#.#.#.#.#.#####...#.#
#...#...........#.#.#
#.###########.###.#.#
#.............#.....#
#.#.##.######.#.#.#.#
#...#.....#.#...#...#
#.###.#.#.#.#####.###
#.......#.......#...#
#.#.#.########.####.#
#...#.#...#.........#
#.#.#.#.#.#.#########
#.....#...#.......#.#
#.#####.#.##.#.##...#
#.....#.#.#.....#.#.#
#.###.#...#.#.#.#.#.#
#.......#.....#.....#
#####################
