31
31
###############################
#.#...#...#...........#.......#
#.###.#.#.#.#######.#.###.###.#
#...#.#.#.....#...#.#...#...#.#
###.#.#.#######.#.#.###.###.#.#
#.#.#.#.#.....#.#.#.#.#.#...#.#
#.#.#.#.#.###.#.#.#.#.#.#.###.#
#...#...#...#.#.#.#.#.....#...#
#.###.#####.#.#.#.#.#######.###
#...#...#.#.#...#.#...#...#.#.#
###.###.#.#.#####.#.#.#.###.#.#
#.#.#...#.#.#...#.#.#.#...#.#.#
#.#.#.###.#.###.#.###.#.#.#.#.#
#...#.....#...#.#.....#.#...#.#
#.#########.#.#.#######.#####.#
#.#.......#.#.#.....#.#.#.#...#
#.#.#####.###.###.#.#.#.#.#.#.#
#...#...#.#...#...#...#.#...#.#
#######.#.#.###.#####.#.#####.#
#.......#...#...#...#.#.#.....#
#.#.###.#######.#.#.#.#.#.#####
#.#...#.#.#.....#.#...#.#.#...#
#.###.#.#.#.#.###.#####.#.#.#.#
#.#...#...#.#.#...#...#.#.#.#.#
###.###.###.#.#####.#.#.#.#.#.#
#...#...#...#.......#...#...#.#
#.###.###.###################.#
#.#.....#.#.....#.......#...#.#
#.#######.###.#.#####.#.#.#.#.#
#.............#.......#...#...#
###############################
