21
31
#####################
#...................#
#.#.#.#.#.#.#.#.#.#.#
#.............#.....#
#.#.#.#.#.#.#.#.#.#.#
#...................#
#.#.#.#.#.#.#.#.#.#.#
#...................#
#.#.#.#.#.#.#.#.#.#.#
#...................#
#.#.#.###.###.#.#.#.#
#...........#.......#
#.#.#.#.#.#.#.#.#.#.#
#...................#
#.#.#.#.#.#.#.###.#.#
#...................#
#.#.#.#.#.#.#.#.#.#.#
#...................#
#.#.#.#.#.#.#.#.#.#.#
#...................#
#.#.#.#.#.#.#.#.#.#.#
#...................#
#.#.#.###.#.#.#.#.#.#
#...........#.......#
#.#.#.#.#.#.#.#.#.#.#
#...................#
#.#.#.#.#.#.#.#.#.#.#
#.........#.........#
#.#.#.###.#.#.#.#.#.#
#...................#
#####################
