31
31
###############################
#.....#...............#...#...#
#####.###.#####.#####.#.#.#.#.#
#...#...#.....#.#...#...#...#.#
#.#.###.###.###.###.#########.#
#.#...#.#...#...#...#.......#.#
#.###.#.###.#.###.#.#.#####.#.#
#...#.#...#.#.#...#.#.....#...#
#.#.#####.#.#.###.#######.#####
#.#.......#.#...#.....#.#.....#
#.#########.###.###.#.#.#####.#
#.........#...#.#...#.....#...#
#########.#.###.#.#######.#.###
#.....#...#.#...#.#.....#.#.#.#
#.#####.#####.###.###.###.#.#.#
#...#...#.....#...#...#...#...#
#.#.#.#####.###.###.###.#####.#
#.#...#.....#...#.....#...#...#
#.#######.###.###.###.###.#.###
#.......#...#.#.....#.....#.#.#
#######.###.#.#############.#.#
#.#.....#...#.......#.......#.#
#.#.#####.###.#####.#.#######.#
#...#.#...#.....#...#.........#
#.###.#.#.#######.###########.#
#.#.....#.......#.#...........#
#.#############.#.#.###########
#.#...#.....#...#...#.........#
#.#.#.#.###.#.###.###########.#
#...#...#.....#...............#
###############################
