41
61
#########################################
#...#.............#.....#...#...........#
#.###.#########.#.#.###.#.#.#.#######.#.#
#.#...#.....#...#...#.....#.#.#...#...#.#
#.#.#####.###.###.#####.#####.#.#.#.###.#
#.........#...#.#.#...#.#...#...#.#.#...#
###########.###.#.#.#.#.#.#.###.###.#####
#...........#.#...#.#.#.#.#.....#...#...#
#.###########.#.###.#.###.#######.###.#.#
#...#.........#...#.#...#...#...#.....#.#
###.#####.#.#####.#.###.###.###.#######.#
#...#...#.#.......#.#.....#.....#.....#.#
#.###.#.###########.#.#########.#.###.#.#
#...#.#.....#...#...#.........#...#...#.#
###.#.#####.#.#.#.#####.#.#.#######.###.#
#...#.....#...#...#...#.#.#.#.....#.#...#
#.#######.#########.#.#.#.###.#.###.#.###
#.......#.#.......#.#.#.#.#...#.....#...#
#.###.###.###.###.#.#.#.#.#.###########.#
#.#.#...#...#...#.#.#.#.#...#.........#.#
#.#.###.###.#.###.#.#.#####.#.#######.#.#
#.....#...#.#.#...#.#.#...#.#.#.....#...#
#####.###.#.#.#.###.#.#.#.###.#####.###.#
#.....#.#...#.#.#...#...#...#.#.......#.#
#.#####.#####.#.#.#########.#.#.#######.#
#.#...#...#...#.#.#.......#...#.#.......#
#.#.#.#.#.#####.#.#.###.#######.#.#######
#...#...#.......#.#...#.......#.#.......#
###########.#####.#####.#.###.#.#######.#
#.........#.#...#.#...#.#.#...#.......#.#
#.#######.###.#.#.#.#.###.#.###.#######.#
#...#...#.....#.#...#.#...#.....#.....#.#
#.#.#.#########.#####.#.#########.###.#.#
#.#.#.#...#.....#.....#.#.......#...#...#
#.#.#.#.#.#.#####.#####.#.#####.###.#####
#.#.#...#.#.#.....#.....#.#.#.....#.#...#
###.#.###.#.###.###.#.#.#.#.#.#####.#.###
#...#...#.#.#...#...#.#.#.#.#.....#.#...#
#.###.###.#.#.#######.#.#.#.#####.#.###.#
#...#.#...#...#.......#.#.....#.#...#...#
###.#.#.#######.#.###########.#.#####.#.#
#...#.#.........#.#.......#...#.......#.#
#.###.#########.###.###.###.###.###.#####
#...#.#.......#.....#.#.....#.#.#.#.....#
#.#.###.#####.#.#####.#######.#.#.#####.#
#.#.#.......#.#...#.....#...#.....#.....#
#.#.#.#######.###.###.#.#.###.#####.###.#
#.#.#.#.....#.#.#.....#.#.....#...#...#.#
#.#.#.#.###.#.#.#######.#######.#.###.#.#
#.#...#.#.....#.......#.#...#...#...#.#.#
#.#####.#.#####.#.###.#.#.#.#.#####.#.###
#.....#.#.#...#.#...#.#.#.#...#...#.#...#
#######.###.#.#.###.###.#.#####.###.###.#
#.....#.#...#.#...#.....#...#.....#...#.#
#.###.#.#.###.###.#######.#.#.###.###.#.#
#.#.#.#.....#.#...#.......#.#.#.....#...#
#.#.#.#######.#.#####.#####.###.#######.#
#.#.#.........#.#...#.....#...#.#.......#
#.#.###########.#.#.#########.#.#.#######
#.#...............#...........#.........#
#########################################
