41
41
#########################################
#...........#.......#.#...#.............#
#####.###.#.#####.#.#.#.#.#.#######.###.#
#.#...#.........#.#.#.......#.......#...#
#.#.###.#######.#.#.###.#####.#######.###
#...#.........#...#...#.#...#...#...#.#.#
#.###.###.#.###.#####.#.#.#####.#.#.#.#.#
#.......#.#.#.....#...#.#.#.....#.#.#.#.#
#.#####.#.###.#.#.#.#.#.#.#.#####...#.#.#
#.#.....#...#.#.#...#.#.#.#...#...#.#.#.#
#...#####.#.#.#.###.#.#.#.###.#.###.#...#
#.#...#...#.#...#...#.#...#...#.....#.#.#
#.#.#.###.#.#.#.###.#.###.#.#####.#.#.#.#
#.#.#...#.#...#.....#.....#.#.....#.#...#
#.###.#.#.#########.###.#.#...#.#######.#
#...................#...#.#.#.#.#.......#
#########.#####.#.###.#####.#.#.#.#####.#
#...#...........#.#...#.....#.#...#.....#
#.#.#.###.#####.#.#.###.#.#####.#######.#
#.#...#.#.....#.#.#.#.....#...#.........#
#.#####.#.###.#.#.#.#.#.###.#.#########.#
#.......#.#...#.#.#.#.......#.#.#...#...#
#.#.#.#.#.#.###...#.#########.#.#.#.#.###
#...#.#.#.#.....#...#.........#...#...#.#
#.#####.#.###.###.#.#.###.#.###.#.###.#.#
#.....#.#...#.....#.#...#...#.......#...#
#####.#.###.#.#####.#.#.######.##.#.###.#
#.#...#...#.#.#.#...#.#.#.........#.#...#
#.#.#####.#.#.#.#.###.#.#.###.##.##.#.###
#.#.......#.#.....#...#...........#.#...#
#.#.#####.#.#####.#.#.###.#######.#.###.#
#.#.....#.#.......#.....#.#.....#.#...#.#
#.#.###.#.#####.###.###.###.###.#####.#.#
#...#.#...........#.#.....#...#...#...#.#
#.###.##.####.###.#.#####.#.#.###.#.###.#
#...........#.#...#.....#.#.#...#...#...#
#.#####.###.#.#.#.#.#.#.#.#.###.#####.###
#.......#.#...#.#.....#.#.#...#...#...#.#
#.#######.#####.###.###.#.#######...###.#
#.......................#.........#.....#
#########################################
