41
41
#########################################
#.#...#...#.......#...................#.#
#.#.#.#.###.#####.#.###########.#####.#.#
#...#.#.#...#...#.#.#.#.......#...#.#...#
#####.#.#.#####.#.#.#.#.#.###.###.#.###.#
#...#.#.......#.#...#...#.#.....#.#.....#
#.###.#######.#.#######.#.#####.#.#######
#...#.....#.#.#.......#.#...#.#.#.......#
#.#.#####.#.#.###.###.###.#.#.#.#######.#
#.#.#...#.#...#...#.#...#.#.#.#.......#.#
#.#.#.#.#.###.#.###.###.###.#.#####.###.#
#.#...#.#...#...#...#...#...#.....#.#...#
#.#####.###.#####.###.###.###.###.#.#.#.#
#...#.#.....#...#.........#...#.#...#.#.#
###.#.#######.###.#########.###.#####.#.#
#.#.#.....#.......#.....#.#.#...#...#.#.#
#.#.#.###.#########.###.#.#.#.###.#.#.#.#
#.#...#.#.#...#...#.#...#.#...#...#.#.#.#
#.#####.#.#.#.#.#.#.#.###.###.#.###.#.#.#
#.......#.#.#.#.#...#.#...#...#.#.#...#.#
#.###.#.#.#.#.#.#####.#.###.###.#.#####.#
#...#.#.#...#...#.#...#.#...#.#.#.#.....#
#.###.#.#########.#.###.#.###.#.#.#.#####
#.#...#.#...#...#...#.....#...#.#.#.#...#
#.#.###.#.###.#.#.###.#######.#.#.#.###.#
#.#...#...#...#.#.#.#.#.......#.#.......#
#.###.#####.###.#.#.#.###.#.#.#.#.#######
#...#.....#...#...#.#...#.#.#.#.#.#.....#
###.#####.###.#####.###.#.#.###.###.###.#
#.#.#...#...#.#...#...#.#.#.#...#.....#.#
#.#.#.#.#.###.#.#.#.#.#.###.#.###.#####.#
#.#.#.#.#.#...#.#...#...#...#.......#...#
#.#.#.###.#.###########.#.###########.#.#
#...#...#...#...#.....#...#...#.....#.#.#
#.#####.#####.#.#.###.#.###.#.#.###.#.###
#.#...#.......#.#.#...#.#...#...#...#...#
#.#.#.#####.###.#.#.#####.#######.#####.#
#...#.#.....#.#...#.#...#.....#.#.#...#.#
#####.#.#####.#####.#.#.#####.#.#.#.#.#.#
#.......#.............#.......#.....#...#
#########################################
