41
41
#########################################
#.#...#...#.......#...................#.#
#.#.#.#.###.#####.#.###########.#####.#.#
#...#.#.#...#...#.#.#.#.......#...#.#...#
#.###.#.#.#####.#.#...#.#.###.###.#.###.#
#...#.#.......#.#...#...#.#.....#.#.....#
#.###.#######.#.#######.#.#####.#.#####.#
#...#.....#.#.#.......#.#...#.#.#.......#
#.#.#####.#.#.###.###.###.#.#.#.#######.#
#.#.#...#.#...#...#.....#.#.#.#.......#.#
#...#.#.#.###.#.###.###.###.#.#.###.###.#
#.#...#.#...#...#...#...#...#.....#.#...#
#.#####.###.#.###.###.###.###.###.#.#.#.#
#...#.#.....#...#.........#...#.#...#.#.#
###.#.#.#####.###.#########.###.#.###.#.#
#.#.#.............#.....#.#.#...#...#.#.#
#.#.#.###.#########.###.#.#.#.###.#.#...#
#.#...#.#.#...#...#.#...#.#...#...#.#.#.#
#.#####.#.#.#.#.#.#.#.#.#.###.#.###.#.#.#
#.......#.#.#.#.#...#.#...#...#.#.#...#.#
#.###.#.#.#.#.#.#####.#.###.###.#.#.###.#
#...#.#.#...#...#.#...#.#...#.#.#.#.....#
#.###.#.#########.#.###.#.###.#.#.#.#####
#.#...#.#...#.............#...#.#.#.#...#
#.#.###.#.###.#.#.###.#######.#.#.#.###.#
#.#...#...#...#.#.#.#.#.......#.#.......#
#.###.#####.###.#...#.#.#.#.#.#.#.#######
#...#.....#...#...#.#.....#.#.#...#.....#
###.#####.###.#####.###.#.#.###.###.###.#
#.#.#...#...#.#...#...#.#.#.#...#.....#.#
#.#.#.#.#.###.#.#.#.#.#.###.#.###.#####.#
#.#.#.#.#.#...#.....#...#...#.......#...#
#.#.#.###.#.###########.#.###########.#.#
#...#...#...#...#.....#...#...#.....#.#.#
#.#####.#.###.#.#.###.#.#.#.#.#.###.#.###
#.#...#.......#.#.#...#.#...#...#...#...#
#.#.#.#####.###.#.#.#####.#######.#####.#
#...#.#.....#.#...#.#...#.....#.#.#...#.#
#####.#.#####.#####.#.#.#####.#.#.#.#.#.#
#.......#.............#.......#.....#...#
#########################################
