#####################
#.#.......#.........#
#.#.#####.#######.#.#
#...#...#.......#.#.#
#####.#.#######.#.#.#
#.#...#.......#.#.#.#
#.#.#.#####.###.#.#.#
#.#.#...#...#...#.#.#
#.#.###.#####.#####.#
#.#...#.......#.....#
#.###.#########.#####
#...#...#...#.......#
#.#.###.#.#.###.###.#
#.#...#.#.#...#.#.#.#
#.###.#.#.###.#.#.#.#
#.#...#...#...#...#.#
#.#########.#######.#
#.#.......#.....#...#
#.#.###.#######.#.#.#
#.....#...........#.#
#####################
