41
41
#########################################
#.....#.....#.......#.#...#.............#
#####.###.#.#####.#.#.#.#.#.#######.###.#
#.#...#...#.....#.#.#...#...#.......#...#
#.#.###.#######.#.#.###.#####.#######.###
#...#...#.....#...#...#.#...#...#...#.#.#
#.###.###.#.#########.#.#.#####.#.#.#.#.#
#.#.....#.#.#.....#.#.#.#.#.....#.#.#.#.#
#.#####.#.###.#.#.#.#.#.#.#.#####.#.#.#.#
#.#.....#...#.#.#...#.#.#.#...#...#.#.#.#
#.#.#####.#.#.#.###.#.#.#.###.#.###.#.#.#
#.#...#...#.#.#.#...#.#...#...#...#.#.#.#
#.#.#.###.#.#.#.#####.###.#.#####.#.#.#.#
#.#.#...#.#...#.....#...#.#.#.....#.#...#
#.#####.###########.###.#.#.#.#.#######.#
#.......#...........#...#.#.#.#.#.......#
#########.#######.###.#####.#.#.#.#######
#...#...........#.#...#.....#.#...#.....#
#.#.#.#########.#.#.###.#.#####.#######.#
#.#...#.#.....#.#.#.#...#.#...#.........#
#.#####.#.###.#.#.#.#.#####.#.#########.#
#...#...#.#...#.#.#.#.......#.#.#...#...#
###.#.#.#.#.###.#.#.#########.#.#.#.#.###
#...#.#.#.#.....#.#.#.....#...#...#...#.#
#.#####.#.#######.#.#.###.#.###.#####.#.#
#.....#.#...#.....#.#...#...#...#...#...#
#####.#.###.#.#####.#.#.#########.#.###.#
#.#...#...#.#.#.#...#.#.#.........#.#...#
#.#.#####.#.#.#.#.#####.#.#########.#.###
#.#.......#.#...#.#...#...........#.#...#
#.#######.#.#####.#.#.###.#######.#.###.#
#.#.....#.#.......#.#...#.#.....#.#...#.#
#.#.###.#.#########.###.###.###.#####.#.#
#...#.#...#.......#.#.....#...#...#...#.#
#.###.#######.###.#.#####.#.#.###.#.###.#
#.#.........#.#.#.#.....#.#.#...#...#...#
#.#####.###.#.#.#.###.#.#.#.###.#####.###
#.......#.#...#.#...#.#.#.#...#...#...#.#
#########.#####.###.###.#.#######.#.###.#
#.......................#.........#.....#
#########################################
