41
61
#########################################
#...#...................................#
#.#.#.#.###.#.#.#.#.#.#.#.#.#.#.#.#.#.#.#
#.......................................#
#.#.#.#.#.#.#.#.#.#.#.#.#.#.#.#.#.#.#.#.#
#.......................................#
#.#.#.#.#.#.#.#.#.#.#.#.#.#.#.#.#.#.#.#.#
#.......................................#
#.#.#.#.#.#.#.#.#.#.#.#.#.#.#.#.#.#.#.#.#
#.......................................#
#.#.#.#.#.#.#.#.#.#.#.#.#.#.#.#.#.#.#.#.#
#.....................................#.#
#.#.#.#.#.#.#.#.#.#.#.#.###.#.#.#.#.#.#.#
#...................#...................#
#.#.#.#.#.#.#.#.#.#.###.#.#.#.#.#.#.#.#.#
#.......................................#
#.#####.#.#.#.#.#.#.#.#.#.#.#.#.#.#.#.#.#
#.........................#.............#
#.#.#.#.#.#.#.#.#.#.#.#.#.#.#.###.#.#.#.#
#...........................#...........#
#.#.#.#.#.#.#.#.#.#.#.#.#.#.#.#.#.###.#.#
#.......................................#
#.#.#.#.#.#.#.#.#.#.#.#.#.#.#.#.#.#.#.#.#
#.......................................#
#.#.#.#.#.#.#.#.#.#.#.#.#.#.#.#.#.###.#.#
#.................#.....................#
#.#.#.#.#.#.#.#.#.#.#.#.#.#.###.#.#.#.#.#
#.................#...........#.........#
###.#.#.#.#.#.#.#.#.#.#.#.#.#.#.#.###.#.#
#.........#.............................#
#.#.###.#.###.#.#.#.#.###.#.###.#.###.#.#
#.......................................#
#.#.#.#.#.#.###.#.#.#.#.#.#.###.#.#.#.#.#
#.......................................#
#.#.#.#.#.#.#.###.#.#.#.#.#.#.#.#.#.#.#.#
#.......................................#
#.#.#.###.#.#.#.#.#.#.#.#.#.#.###.#.#.#.#
#...........#...........................#
#.#.#.#.#.#.#.#.#.#.#.#.#.#.#.#.#.#.#.#.#
#.......................................#
#.#.#.#.###.#.#.#.#.#.#.#.#.#.#.#.#.#.#.#
#.........................#.............#
#.###.#.#.###.#.#.#.#.#.#.#.#.#.#.#.#.#.#
#.....................#.................#
#.#.#.#.#.#.#.#.###.#.#.#.#.#.#.#.#.#.#.#
#.#.....................................#
#.#.#.###.#.#.#.#.#.#.#.#.#.#.#.#.#.#.#.#
#.................................#.....#
#.#.#.#.#.#.#.#.#.###.#.#.#.#.#.#.#.#.#.#
#.....................................#.#
#.#.#.#.#.#.#.#.#.#.#.#.#.#.#.#.#.#.#.###
#.....#...................#.............#
#.#.###.###.#.#.#.#.#.#.#.#.#.#.#.#.#.#.#
#.......................................#
#.#.#.#.#.#.#.###.#.#.#.#.#.#.#.#.#.#.#.#
#...........................#...........#
#.#.#.#.#.###.#.#.#.#.#.#.#.#.#.#.#.#.#.#
#.#...........#.........................#
#.#.#.#.#.#.#.#.#.#.#.#.#.#.#.#.#.#.#.#.#
#.......................................#
#########################################
